Country Name,Total Samples,Total Correct Predictions,Total Incorrect Predictions,True Positives (TP),True Negatives (TN),False Positives (FP),False Negatives (FN),Accuracy,Precision,Recall,F1-score,AUC-ROC,AUC-PR
AFG,54,53,1,0,53,1,0,0.9814814814814815,0.0,0.0,0.0,Not defined (single class),Not defined (single class)
AGO,118,118,0,14,104,0,0,1.0,1.0,1.0,1.0,1.0,0.9999999999999999
ALB,13,4,9,0,4,9,0,0.3076923076923077,0.0,0.0,0.0,Not defined (single class),Not defined (single class)
AND,1,0,1,0,0,1,0,0.0,0.0,0.0,0.0,Not defined (single class),Not defined (single class)
ARE,78,78,0,0,78,0,0,1.0,0.0,0.0,0.0,Not defined (single class),Not defined (single class)
ARG,313,299,14,53,246,13,1,0.9552715654952076,0.803030303030303,0.9814814814814815,0.8833333333333333,0.9906334906334906,0.9555345264830795
ARM,33,31,2,0,31,2,0,0.9393939393939394,0.0,0.0,0.0,Not defined (single class),Not defined (single class)
AUS,1470,1388,82,857,531,82,0,0.9442176870748299,0.9126730564430245,1.0,0.9543429844097996,0.9989245080814176,0.9992356546318153
AUT,1340,1302,38,117,1185,38,0,0.9716417910447761,0.7548387096774194,1.0,0.8602941176470589,0.9992312584299502,0.9928586754338238
AZE,35,29,6,1,28,6,0,0.8285714285714286,0.14285714285714285,1.0,0.25,1.0,1.0
BDI,11,11,0,0,11,0,0,1.0,0.0,0.0,0.0,Not defined (single class),Not defined (single class)
BEL,920,835,85,174,661,85,0,0.907608695652174,0.6718146718146718,1.0,0.8036951501154734,0.9977504545314474,0.9907787826626169
BEN,47,47,0,0,47,0,0,1.0,0.0,0.0,0.0,Not defined (single class),Not defined (single class)
BFA,81,79,2,0,79,0,2,0.9753086419753086,0.0,0.0,0.0,1.0,1.0
BGD,848,815,33,370,445,33,0,0.9610849056603774,0.9181141439205955,1.0,0.9573091849935317,0.9997285988917789,0.9996485174721157
BGR,133,119,14,11,108,14,0,0.8947368421052632,0.44,1.0,0.6111111111111112,0.9955290611028317,0.9606060606060607
BHR,4,4,0,0,4,0,0,1.0,0.0,0.0,0.0,Not defined (single class),Not defined (single class)
BHS,7,7,0,0,7,0,0,1.0,0.0,0.0,0.0,Not defined (single class),Not defined (single class)
BIH,115,106,9,0,106,9,0,0.9217391304347826,0.0,0.0,0.0,Not defined (single class),Not defined (single class)
BLR,496,484,12,32,452,12,0,0.9758064516129032,0.7272727272727273,1.0,0.8421052631578947,0.9995285560344828,0.9935014840949821
BLZ,47,47,0,13,34,0,0,1.0,1.0,1.0,1.0,1.0,0.9999999999999998
BOL,40,37,3,1,36,3,0,0.925,0.25,1.0,0.4,1.0,1.0
BRA,16263,16187,76,658,15529,73,3,0.9953268154707003,0.9001367989056087,0.9954614220877458,0.9454022988505747,0.9998958588070385,0.9977189533022688
BRB,36,36,0,0,36,0,0,1.0,0.0,0.0,0.0,Not defined (single class),Not defined (single class)
BRN,4,4,0,0,4,0,0,1.0,0.0,0.0,0.0,Not defined (single class),Not defined (single class)
BTN,1,1,0,0,1,0,0,1.0,0.0,0.0,0.0,Not defined (single class),Not defined (single class)
BWA,141,139,2,1,138,2,0,0.9858156028368794,0.3333333333333333,1.0,0.5,1.0,1.0
CAF,39,39,0,0,39,0,0,1.0,0.0,0.0,0.0,Not defined (single class),Not defined (single class)
CAN,3954,3837,117,1013,2824,117,0,0.9704097116843703,0.8964601769911504,1.0,0.9454036397573495,0.9994095795797107,0.9982490175881402
CHE,666,644,22,75,569,22,0,0.9669669669669669,0.7731958762886598,1.0,0.872093023255814,0.9984433164128595,0.9899512862613193
CHL,1534,1500,34,1438,62,34,0,0.9778357235984355,0.9769021739130435,1.0,0.9883161512027492,0.9915609063514139,0.9994089631058325
CHN,1955,1926,29,111,1815,27,2,0.9851662404092072,0.8043478260869565,0.9823008849557522,0.8844621513944223,0.998520269426268,0.9746379435823196
CIV,96,93,3,17,76,1,2,0.96875,0.9444444444444444,0.8947368421052632,0.918918918918919,0.9856459330143541,0.9106317859263109
CMR,752,749,3,4,745,3,0,0.9960106382978723,0.5714285714285714,1.0,0.7272727272727273,0.9993315508021391,0.8875
COD,514,509,5,12,497,4,1,0.9902723735408561,0.75,0.9230769230769231,0.8275862068965517,0.9987716873944418,0.9706959706959704
COG,2,0,2,0,0,2,0,0.0,0.0,0.0,0.0,Not defined (single class),Not defined (single class)
COL,201,174,27,81,93,26,1,0.8656716417910447,0.7570093457943925,0.9878048780487805,0.8571428571428571,0.991699118671859,0.9884263280127287
COM,3,1,2,0,1,2,0,0.3333333333333333,0.0,0.0,0.0,Not defined (single class),Not defined (single class)
CPV,14,12,2,0,12,2,0,0.8571428571428571,0.0,0.0,0.0,Not defined (single class),Not defined (single class)
CRI,29,26,3,0,26,3,0,0.896551724137931,0.0,0.0,0.0,Not defined (single class),Not defined (single class)
CUB,39,33,6,0,33,6,0,0.8461538461538461,0.0,0.0,0.0,Not defined (single class),Not defined (single class)
CYM,1,0,1,0,0,1,0,0.0,0.0,0.0,0.0,Not defined (single class),Not defined (single class)
CYP,54,53,1,31,22,1,0,0.9814814814814815,0.96875,1.0,0.9841269841269841,1.0,0.9999999999999998
CZE,4636,4607,29,3999,608,28,1,0.9937446074201898,0.993046933200894,0.99975,0.9963871932228728,0.9999123427672956,0.9999860535492022
DEU,6493,6213,280,485,5728,275,5,0.9568766363776374,0.6381578947368421,0.9897959183673469,0.776,0.9970450149075123,0.9751558079082604
DMA,2,2,0,0,2,0,0,1.0,0.0,0.0,0.0,Not defined (single class),Not defined (single class)
DNK,13046,13045,1,6,13039,1,0,0.9999233481526905,0.8571428571428571,1.0,0.9230769230769231,1.0,1.0
DOM,44,44,0,0,44,0,0,1.0,0.0,0.0,0.0,Not defined (single class),Not defined (single class)
DZA,192,191,1,0,191,0,1,0.9947916666666666,0.0,0.0,0.0,0.9790575916230367,0.2
ECU,207,194,13,30,164,13,0,0.9371980676328503,0.6976744186046512,1.0,0.821917808219178,0.991713747645951,0.9411922989848769
EGY,115,114,1,0,114,1,0,0.991304347826087,0.0,0.0,0.0,Not defined (single class),Not defined (single class)
ERI,27,26,1,0,26,1,0,0.9629629629629629,0.0,0.0,0.0,Not defined (single class),Not defined (single class)
ESP,2895,2704,191,887,1817,190,1,0.9340241796200346,0.8235840297121634,0.9988738738738738,0.9027989821882951,0.9942105782912958,0.9805658515404686
EST,18,17,1,0,17,1,0,0.9444444444444444,0.0,0.0,0.0,Not defined (single class),Not defined (single class)
ETH,86,85,1,1,84,1,0,0.9883720930232558,0.5,1.0,0.6666666666666666,1.0,1.0
FIN,599,582,17,8,574,14,3,0.9716193656093489,0.36363636363636365,0.7272727272727273,0.48484848484848486,0.990878169449598,0.8059448560592726
FJI,10,8,2,8,0,2,0,0.8,0.8,1.0,0.8888888888888888,0.9375,0.9861111111111112
FLK,9,6,3,0,6,3,0,0.6666666666666666,0.0,0.0,0.0,Not defined (single class),Not defined (single class)
FRA,4108,3900,208,641,3259,205,3,0.9493670886075949,0.7576832151300237,0.9953416149068323,0.8604026845637583,0.9987300611076844,0.9939269797778596
FRO,18,18,0,0,18,0,0,1.0,0.0,0.0,0.0,Not defined (single class),Not defined (single class)
GAB,19,17,2,0,17,2,0,0.8947368421052632,0.0,0.0,0.0,Not defined (single class),Not defined (single class)
GBR,2347,2192,155,354,1838,153,2,0.9339582445675331,0.6982248520710059,0.9943820224719101,0.8203939745075318,0.9972093521972472,0.9852411897996253
GEO,99,95,4,2,93,4,0,0.9595959595959596,0.3333333333333333,1.0,0.5,0.9793814432989691,0.6666666666666666
GGY,2,2,0,0,2,0,0,1.0,0.0,0.0,0.0,Not defined (single class),Not defined (single class)
GHA,118,115,3,0,115,1,2,0.9745762711864406,0.0,0.0,0.0,0.9698275862068965,0.30952380952380953
GIN,158,157,1,0,157,0,1,0.9936708860759493,0.0,0.0,0.0,0.9808917197452229,0.25
GRC,371,346,25,154,192,25,0,0.9326145552560647,0.8603351955307262,1.0,0.924924924924925,0.9976659285415046,0.9967182692686832
GRD,1,1,0,0,1,0,0,1.0,0.0,0.0,0.0,Not defined (single class),Not defined (single class)
GRL,15,15,0,4,11,0,0,1.0,1.0,1.0,1.0,1.0,1.0
GTM,111,105,6,22,83,6,0,0.9459459459459459,0.7857142857142857,1.0,0.88,0.979570990806946,0.8430392557010906
GUY,16,16,0,1,15,0,0,1.0,1.0,1.0,1.0,1.0,1.0
HND,34,33,1,0,33,1,0,0.9705882352941176,0.0,0.0,0.0,Not defined (single class),Not defined (single class)
HRV,343,331,12,178,153,12,0,0.9650145772594753,0.9368421052631579,1.0,0.967391304347826,0.992066734763364,0.9886663484539254
HTI,120,120,0,1,119,0,0,1.0,1.0,1.0,1.0,1.0,1.0
HUN,445,419,26,72,347,26,0,0.9415730337078652,0.7346938775510204,1.0,0.8470588235294118,0.9993669943401848,0.9968875204144041
IDN,5782,5718,64,2803,2915,64,0,0.9889311656866137,0.9776770143006627,1.0,0.9887125220458554,0.9999859882538453,0.9999851073291726
IMN,2,1,1,0,1,0,1,0.5,0.0,0.0,0.0,1.0,1.0
IND,1704,1646,58,160,1486,55,3,0.965962441314554,0.7441860465116279,0.9815950920245399,0.8465608465608465,0.9894300171588045,0.9670807809684773
IRL,252,207,45,50,157,45,0,0.8214285714285714,0.5263157894736842,1.0,0.6896551724137931,0.9914851485148516,0.9702574972992432
IRN,1908,1879,29,1564,315,29,0,0.9848008385744235,0.9817953546767106,1.0,0.9908140639847957,0.99997955451139,0.9999954972625689
IRQ,75,60,15,2,58,15,0,0.8,0.11764705882352941,1.0,0.21052631578947367,1.0,1.0
ISL,128,127,1,3,124,1,0,0.9921875,0.75,1.0,0.8571428571428571,1.0000000000000002,1.0
ISR,278,265,13,20,245,12,1,0.9532374100719424,0.625,0.9523809523809523,0.7547169811320755,0.9933296275708727,0.9405793556245008
ITA,4484,4363,121,1744,2619,121,0,0.9730151650312221,0.9351206434316354,1.0,0.9664727071210861,0.9996521964776,0.9994434599149528
JAM,13,13,0,0,13,0,0,1.0,0.0,0.0,0.0,Not defined (single class),Not defined (single class)
JEY,2,2,0,0,2,0,0,1.0,0.0,0.0,0.0,Not defined (single class),Not defined (single class)
JOR,54,51,3,0,51,3,0,0.9444444444444444,0.0,0.0,0.0,Not defined (single class),Not defined (single class)
JPN,2791,2728,63,361,2367,61,2,0.977427445360086,0.8554502369668247,0.9944903581267218,0.9197452229299363,0.9991910266359869,0.9968919787382169
KAZ,586,580,6,115,465,6,0,0.9897610921501706,0.9504132231404959,1.0,0.9745762711864406,0.9999630757869473,0.9998513563730954
KEN,272,264,8,1,263,8,0,0.9705882352941176,0.1111111111111111,1.0,0.2,1.0,1.0
KGZ,8,3,5,0,3,5,0,0.375,0.0,0.0,0.0,Not defined (single class),Not defined (single class)
KHM,42,38,4,4,34,4,0,0.9047619047619048,0.5,1.0,0.6666666666666666,1.0,1.0
KNA,3,0,3,0,0,3,0,0.0,0.0,0.0,0.0,Not defined (single class),Not defined (single class)
KOR,396,371,25,75,296,25,0,0.9368686868686869,0.75,1.0,0.8571428571428571,0.9946002076843198,0.9734584473987743
KWT,104,102,2,10,92,2,0,0.9807692307692307,0.8333333333333334,1.0,0.9090909090909091,1.0,0.9999999999999999
LAO,39,32,7,1,31,6,1,0.8205128205128205,0.14285714285714285,0.5,0.2222222222222222,0.9054054054054054,0.6111111111111112
LBN,74,71,3,22,49,3,0,0.9594594594594594,0.88,1.0,0.9361702127659575,1.0,1.0
LBR,48,43,5,0,43,4,1,0.8958333333333334,0.0,0.0,0.0,0.8936170212765958,0.16666666666666666
LBY,41,40,1,0,40,1,0,0.975609756097561,0.0,0.0,0.0,Not defined (single class),Not defined (single class)
LCA,3,3,0,0,3,0,0,1.0,0.0,0.0,0.0,Not defined (single class),Not defined (single class)
LIE,34,34,0,0,34,0,0,1.0,0.0,0.0,0.0,Not defined (single class),Not defined (single class)
LKA,123,117,6,13,104,6,0,0.9512195121951219,0.6842105263157895,1.0,0.8125,0.9986013986013986,0.9885883347421809
LSO,231,229,2,1,228,2,0,0.9913419913419913,0.3333333333333333,1.0,0.5,0.9956521739130435,0.5
LTU,207,203,4,0,203,4,0,0.9806763285024155,0.0,0.0,0.0,Not defined (single class),Not defined (single class)
LUX,24,20,4,1,19,4,0,0.8333333333333334,0.2,1.0,0.3333333333333333,1.0,1.0
LVA,213,199,14,128,71,14,0,0.9342723004694836,0.9014084507042254,1.0,0.9481481481481482,0.9918198529411766,0.9940728006995934
MAR,211,208,3,0,208,2,1,0.985781990521327,0.0,0.0,0.0,0.9904761904761904,0.3333333333333333
MDA,231,217,14,127,90,14,0,0.9393939393939394,0.900709219858156,1.0,0.9477611940298507,0.9993943064809206,0.9995062760067523
MDG,57,57,0,0,57,0,0,1.0,0.0,0.0,0.0,Not defined (single class),Not defined (single class)
MDV,4,3,1,0,3,1,0,0.75,0.0,0.0,0.0,Not defined (single class),Not defined (single class)
MEX,923,857,66,467,390,66,0,0.9284940411700975,0.8761726078799249,1.0,0.934,0.9970321950486496,0.9970406478422882
MKD,16,14,2,8,6,2,0,0.875,0.8,1.0,0.8888888888888888,1.0,1.0
MLI,388,385,3,65,320,2,1,0.9922680412371134,0.9701492537313433,0.9848484848484849,0.9774436090225563,0.9997647280255977,0.9988785698271864
MLT,17,16,1,15,1,1,0,0.9411764705882353,0.9375,1.0,0.967741935483871,1.0,1.0
MMR,172,169,3,2,167,3,0,0.9825581395348837,0.4,1.0,0.5714285714285714,1.0,1.0
MNE,6,5,1,2,3,1,0,0.8333333333333334,0.6666666666666666,1.0,0.8,0.75,0.5833333333333333
MNG,14,11,3,0,11,3,0,0.7857142857142857,0.0,0.0,0.0,Not defined (single class),Not defined (single class)
MOZ,485,474,11,28,446,9,2,0.977319587628866,0.7567567567567568,0.9333333333333333,0.835820895522388,0.998021978021978,0.9756794284561979
MRT,23,22,1,21,1,1,0,0.9565217391304348,0.9545454545454546,1.0,0.9767441860465116,1.0,1.0
MUS,3,0,3,0,0,3,0,0.0,0.0,0.0,0.0,Not defined (single class),Not defined (single class)
MWI,430,419,11,178,241,11,0,0.9744186046511628,0.9417989417989417,1.0,0.9700272479564033,0.9988407347957909,0.9982974074222862
MYS,434,414,20,70,344,20,0,0.9539170506912442,0.7777777777777778,1.0,0.875,0.9909733124018838,0.9226303503699426
NAM,13,10,3,0,10,3,0,0.7692307692307693,0.0,0.0,0.0,Not defined (single class),Not defined (single class)
NER,75,72,3,3,69,3,0,0.96,0.5,1.0,0.6666666666666666,1.0,1.0
NGA,430,424,6,7,417,6,0,0.986046511627907,0.5384615384615384,1.0,0.7,0.9993245525160419,0.9642857142857142
NIC,14,14,0,7,7,0,0,1.0,1.0,1.0,1.0,1.0,0.9999999999999999
NLD,4051,3957,94,365,3592,94,0,0.9767958528758331,0.7952069716775599,1.0,0.8859223300970874,0.9995049762522392,0.9949800987799338
NOR,3070,3055,15,454,2601,15,0,0.995114006514658,0.9680170575692963,1.0,0.9837486457204767,0.9999882121542794,0.9999326028639394
NPL,294,294,0,0,294,0,0,1.0,0.0,0.0,0.0,Not defined (single class),Not defined (single class)
NZL,781,757,24,265,492,24,0,0.969270166453265,0.916955017301038,1.0,0.9566787003610109,0.9961752230510459,0.9903105495784084
OMN,16,13,3,0,13,3,0,0.8125,0.0,0.0,0.0,Not defined (single class),Not defined (single class)
PAK,54,52,2,3,49,2,0,0.9629629629629629,0.6,1.0,0.75,0.9803921568627451,0.7555555555555555
PAN,8,6,2,3,3,2,0,0.75,0.6,1.0,0.75,1.0,1.0
PER,152,141,11,23,118,11,0,0.9276315789473685,0.6764705882352942,1.0,0.8070175438596491,0.9973036737445231,0.9850310559006211
PHL,753,718,35,256,462,35,0,0.953519256308101,0.8797250859106529,1.0,0.9360146252285192,0.998545963279678,0.9964014053911665
PNG,61,61,0,49,12,0,0,1.0,1.0,1.0,1.0,1.0,1.0
POL,2273,2253,20,41,2212,19,1,0.9912010558732952,0.6833333333333333,0.9761904761904762,0.803921568627451,0.9992956393673561,0.9831420505831047
PRK,5,4,1,0,4,1,0,0.8,0.0,0.0,0.0,Not defined (single class),Not defined (single class)
PRT,590,570,20,46,524,20,0,0.9661016949152542,0.696969696969697,1.0,0.8214285714285714,0.9996403452685423,0.9964426877470356
PRY,102,95,7,22,73,7,0,0.9313725490196079,0.7586206896551724,1.0,0.8627450980392157,1.0,1.0
QAT,39,37,2,0,37,2,0,0.9487179487179487,0.0,0.0,0.0,Not defined (single class),Not defined (single class)
ROU,302,285,17,165,120,17,0,0.9437086092715232,0.9065934065934066,1.0,0.9510086455331412,0.987436407874364,0.9854461430143968
RUS,6468,6357,111,244,6113,109,2,0.9828385899814471,0.6912181303116147,0.991869918699187,0.8146911519198664,0.9994289865753045,0.9887813358881897
RWA,101,101,0,0,101,0,0,1.0,0.0,0.0,0.0,Not defined (single class),Not defined (single class)
SAU,127,124,3,9,115,3,0,0.9763779527559056,0.75,1.0,0.8571428571428571,0.9971751412429378,0.9722222222222223
SDN,5,4,1,0,4,1,0,0.8,0.0,0.0,0.0,Not defined (single class),Not defined (single class)
SEN,3174,3170,4,3168,2,4,0,0.9987397605545053,0.9987389659520807,1.0,0.9993690851735015,0.9847958754208754,0.999969845672976
SGP,89,79,10,21,58,10,0,0.8876404494382022,0.6774193548387096,1.0,0.8076923076923077,0.9908963585434173,0.972177035065234
SLB,1,1,0,1,0,0,0,1.0,1.0,1.0,1.0,Not defined (single class),Not defined (single class)
SLE,171,159,12,117,42,11,1,0.9298245614035088,0.9140625,0.9915254237288136,0.9512195121951219,0.9902462424048609,0.9959272674471054
SLV,3,0,3,0,0,3,0,0.0,0.0,0.0,0.0,Not defined (single class),Not defined (single class)
SOM,127,127,0,0,127,0,0,1.0,0.0,0.0,0.0,Not defined (single class),Not defined (single class)
SRB,245,231,14,11,220,14,0,0.9428571428571428,0.44,1.0,0.6111111111111112,0.9945609945609944,0.8352453102453102
SSD,161,160,1,2,158,1,0,0.9937888198757764,0.6666666666666666,1.0,0.8,1.0,1.0
STP,1,1,0,0,1,0,0,1.0,0.0,0.0,0.0,Not defined (single class),Not defined (single class)
SUR,26,22,4,1,21,4,0,0.8461538461538461,0.2,1.0,0.3333333333333333,1.0,1.0
SVK,335,303,32,81,222,32,0,0.9044776119402985,0.7168141592920354,1.0,0.8350515463917526,0.9917857490035968,0.9688901246470294
SVN,146,131,15,52,79,15,0,0.8972602739726028,0.7761194029850746,1.0,0.8739495798319328,0.9991816693944353,0.9986263736263739
SWE,759,728,31,47,681,31,0,0.9591567852437418,0.6025641025641025,1.0,0.752,0.9987748027731294,0.9837009971669461
SWZ,65,63,2,14,49,1,1,0.9692307692307692,0.9333333333333333,0.9333333333333333,0.9333333333333333,0.9986666666666667,0.9958333333333333
SYC,20,19,1,19,0,1,0,0.95,0.95,1.0,0.9743589743589743,1.0,1.0
SYR,12,8,4,1,7,4,0,0.6666666666666666,0.2,1.0,0.3333333333333333,1.0,1.0
TCD,81,80,1,0,80,1,0,0.9876543209876543,0.0,0.0,0.0,Not defined (single class),Not defined (single class)
TGO,33,30,3,0,30,2,1,0.9090909090909091,0.0,0.0,0.0,0.84375,0.16666666666666666
THA,291,280,11,39,241,11,0,0.9621993127147767,0.78,1.0,0.8764044943820225,0.991045991045991,0.9144321981323436
TKM,15,11,4,4,7,4,0,0.7333333333333333,0.5,1.0,0.6666666666666666,1.0,1.0
TLS,4,4,0,0,4,0,0,1.0,0.0,0.0,0.0,Not defined (single class),Not defined (single class)
TTO,5,3,2,0,3,2,0,0.6,0.0,0.0,0.0,Not defined (single class),Not defined (single class)
TUN,95,88,7,8,80,7,0,0.9263157894736842,0.5333333333333333,1.0,0.6956521739130435,1.0,1.0
TUR,341,307,34,68,239,34,0,0.9002932551319648,0.6666666666666666,1.0,0.8,0.9971450118508942,0.9888854502968916
TWN,1365,1349,16,8,1341,14,2,0.9882783882783883,0.36363636363636365,0.8,0.5,0.9969741697416974,0.8454761904761904
TZA,875,873,2,5,868,2,0,0.9977142857142857,0.7142857142857143,1.0,0.8333333333333334,1.0,1.0
UGA,431,430,1,4,426,0,1,0.9976798143851509,1.0,0.8,0.8888888888888888,1.0,1.0
UKR,1284,1228,56,89,1139,55,1,0.956386292834891,0.6180555555555556,0.9888888888888889,0.7606837606837606,0.9981574539363484,0.9817637828885016
URY,127,126,1,8,118,1,0,0.9921259842519685,0.8888888888888888,1.0,0.9411764705882353,1.0,1.0
USA,26061,25168,893,3763,21405,889,4,0.9657342389010398,0.8088993981083406,0.9989381470666313,0.8939303955339114,0.9987006185576732,0.9902538852330373
UZB,24,21,3,4,17,2,1,0.875,0.6666666666666666,0.8,0.7272727272727273,0.9684210526315788,0.925
VEN,59,55,4,15,40,4,0,0.9322033898305084,0.7894736842105263,1.0,0.8823529411764706,0.9893939393939395,0.9632159507159508
VNM,485,469,16,250,219,16,0,0.9670103092783505,0.9398496240601504,1.0,0.9689922480620154,0.9969021276595744,0.9965969042428932
VUT,1,1,0,0,1,0,0,1.0,0.0,0.0,0.0,Not defined (single class),Not defined (single class)
XKX,18,10,8,9,1,8,0,0.5555555555555556,0.5294117647058824,1.0,0.6923076923076923,0.9506172839506173,0.9467813051146385
YEM,9,9,0,0,9,0,0,1.0,0.0,0.0,0.0,Not defined (single class),Not defined (single class)
ZAF,146,141,5,0,141,4,1,0.9657534246575342,0.0,0.0,0.0,0.9448275862068966,0.1111111111111111
ZMB,164,161,3,7,154,3,0,0.9817073170731707,0.7,1.0,0.8235294117647058,1.0,0.9999999999999998
ZWE,453,433,20,181,252,20,0,0.9558498896247241,0.900497512437811,1.0,0.9476439790575916,1.0,1.0
