Country Name,Total Samples,Total Correct Predictions,Total Incorrect Predictions,True Positives (TP),True Negatives (TN),False Positives (FP),False Negatives (FN),Accuracy,Precision,Recall,F1-score,AUC-ROC,AUC-PR
AFG,77,77,0,0,77,0,0,1.0,0.0,0.0,0.0,Not defined (single class),Not defined (single class)
AGO,139,139,0,13,126,0,0,1.0,1.0,1.0,1.0,1.0,1.0
ALB,21,20,1,0,20,1,0,0.9523809523809523,0.0,0.0,0.0,Not defined (single class),Not defined (single class)
AND,2,2,0,0,2,0,0,1.0,0.0,0.0,0.0,Not defined (single class),Not defined (single class)
ARE,122,122,0,0,122,0,0,1.0,0.0,0.0,0.0,Not defined (single class),Not defined (single class)
ARG,526,513,13,51,462,13,0,0.9752851711026616,0.796875,1.0,0.8869565217391304,0.999298245614035,0.9937819704982781
ARM,71,70,1,2,68,1,0,0.9859154929577465,0.6666666666666666,1.0,0.8,0.9927536231884058,0.8333333333333333
AUS,2139,2126,13,906,1220,12,1,0.9939223936418887,0.9869281045751634,0.9988974641675854,0.9928767123287672,0.9999328813413708,0.9999085571548575
AUT,1489,1481,8,119,1362,8,0,0.9946272666218939,0.937007874015748,1.0,0.967479674796748,0.9998895908728455,0.9987245269583848
AZE,58,53,5,4,49,5,0,0.9137931034482759,0.4444444444444444,1.0,0.6153846153846154,0.9953703703703703,0.95
BDI,51,49,2,0,49,2,0,0.9607843137254902,0.0,0.0,0.0,Not defined (single class),Not defined (single class)
BEL,1463,1447,16,157,1290,16,0,0.9890635680109364,0.9075144508670521,1.0,0.9515151515151515,0.9993318442075282,0.9934018072372445
BEN,38,38,0,0,38,0,0,1.0,0.0,0.0,0.0,Not defined (single class),Not defined (single class)
BFA,76,76,0,0,76,0,0,1.0,0.0,0.0,0.0,Not defined (single class),Not defined (single class)
BGD,1265,1255,10,418,837,10,0,0.9920948616600791,0.9766355140186916,1.0,0.9881796690307328,0.9999745795744056,0.9999489915822541
BGR,193,189,4,6,183,4,0,0.9792746113989638,0.6,1.0,0.75,1.0,1.0
BHR,182,182,0,0,182,0,0,1.0,0.0,0.0,0.0,Not defined (single class),Not defined (single class)
BHS,29,28,1,0,28,1,0,0.9655172413793104,0.0,0.0,0.0,Not defined (single class),Not defined (single class)
BIH,181,180,1,0,180,1,0,0.994475138121547,0.0,0.0,0.0,Not defined (single class),Not defined (single class)
BLR,711,704,7,28,676,6,1,0.9901547116736991,0.8235294117647058,0.9655172413793104,0.8888888888888888,0.9994943877035088,0.9902454178316247
BLZ,67,67,0,12,55,0,0,1.0,1.0,1.0,1.0,1.0,1.0
BOL,105,104,1,0,104,1,0,0.9904761904761905,0.0,0.0,0.0,Not defined (single class),Not defined (single class)
BRA,2692,2658,34,683,1975,33,1,0.987369985141159,0.9539106145251397,0.9985380116959064,0.9757142857142858,0.99992791989935,0.9997940021846109
BRB,32,32,0,0,32,0,0,1.0,0.0,0.0,0.0,Not defined (single class),Not defined (single class)
BRN,6,6,0,0,6,0,0,1.0,0.0,0.0,0.0,Not defined (single class),Not defined (single class)
BTN,7,7,0,0,7,0,0,1.0,0.0,0.0,0.0,Not defined (single class),Not defined (single class)
BWA,141,139,2,0,139,2,0,0.9858156028368794,0.0,0.0,0.0,Not defined (single class),Not defined (single class)
CAF,113,113,0,0,113,0,0,1.0,0.0,0.0,0.0,Not defined (single class),Not defined (single class)
CAN,4147,4115,32,1017,3098,32,0,0.992283578490475,0.9694947569113441,1.0,0.9845111326234269,0.999910781883696,0.9997229347014732
CHE,840,835,5,67,768,4,1,0.9940476190476191,0.9436619718309859,0.9852941176470589,0.9640287769784173,0.9999238037183784,0.9991830065359475
CHL,1814,1808,6,1445,363,6,0,0.9966923925027563,0.9958649207443143,1.0,0.9979281767955801,0.9999812454871954,0.9999952160777132
CHN,2777,2770,7,124,2646,7,0,0.9974792942023767,0.9465648854961832,1.0,0.9725490196078431,0.9999787215933271,0.9995414344293744
CIV,125,124,1,18,106,1,0,0.992,0.9473684210526315,1.0,0.972972972972973,1.0,1.0
CMR,896,896,0,0,896,0,0,1.0,0.0,0.0,0.0,Not defined (single class),Not defined (single class)
COD,1392,1391,1,11,1380,1,0,0.9992816091954023,0.9166666666666666,1.0,0.9565217391304348,1.0,1.0
COG,3,3,0,0,3,0,0,1.0,0.0,0.0,0.0,Not defined (single class),Not defined (single class)
COK,1,1,0,0,1,0,0,1.0,0.0,0.0,0.0,Not defined (single class),Not defined (single class)
COL,1140,1135,5,70,1065,5,0,0.9956140350877193,0.9333333333333333,1.0,0.9655172413793104,0.9999599465954605,0.9993990929705215
COM,3,3,0,0,3,0,0,1.0,0.0,0.0,0.0,Not defined (single class),Not defined (single class)
CPV,41,41,0,0,41,0,0,1.0,0.0,0.0,0.0,Not defined (single class),Not defined (single class)
CRI,86,83,3,0,83,3,0,0.9651162790697675,0.0,0.0,0.0,Not defined (single class),Not defined (single class)
CUB,117,115,2,1,114,2,0,0.9829059829059829,0.3333333333333333,1.0,0.5,1.0,1.0
CYP,57,57,0,23,34,0,0,1.0,1.0,1.0,1.0,1.0,0.9999999999999999
CZE,5095,5088,7,3962,1126,7,0,0.9986261040235525,0.9982363315696648,1.0,0.999117387466902,0.9999828467528904,0.9999950738876205
DEU,10010,9936,74,490,9446,70,4,0.9926073926073926,0.875,0.9919028340080972,0.9297912713472486,0.9990876222956265,0.9951159004678779
DMA,2,2,0,0,2,0,0,1.0,0.0,0.0,0.0,Not defined (single class),Not defined (single class)
DNK,645,641,4,12,629,4,0,0.993798449612403,0.75,1.0,0.8571428571428571,1.0,1.0
DOM,52,51,1,1,50,1,0,0.9807692307692307,0.5,1.0,0.6666666666666666,1.0,1.0
DZA,219,218,1,0,218,1,0,0.9954337899543378,0.0,0.0,0.0,Not defined (single class),Not defined (single class)
ECU,321,317,4,28,289,4,0,0.9875389408099688,0.875,1.0,0.9333333333333333,0.999634324719649,0.9965437788018432
EGY,124,124,0,0,124,0,0,1.0,0.0,0.0,0.0,Not defined (single class),Not defined (single class)
ERI,38,38,0,0,38,0,0,1.0,0.0,0.0,0.0,Not defined (single class),Not defined (single class)
ESP,2784,2725,59,901,1824,59,0,0.9788074712643678,0.9385416666666667,1.0,0.9682966147232671,0.9996858391248764,0.9992965108942543
EST,28,28,0,1,27,0,0,1.0,1.0,1.0,1.0,1.0,1.0
ETH,134,134,0,0,134,0,0,1.0,0.0,0.0,0.0,Not defined (single class),Not defined (single class)
FIN,654,646,8,8,638,8,0,0.9877675840978594,0.5,1.0,0.6666666666666666,1.0,1.0
FJI,13,12,1,6,6,1,0,0.9230769230769231,0.8571428571428571,1.0,0.9230769230769231,1.0,1.0
FLK,6,6,0,0,6,0,0,1.0,0.0,0.0,0.0,Not defined (single class),Not defined (single class)
FRA,6383,6344,39,593,5751,39,0,0.9938900203665988,0.9382911392405063,1.0,0.9681632653061224,0.9999472836518158,0.9994685084595917
FRO,2,1,1,0,1,1,0,0.5,0.0,0.0,0.0,Not defined (single class),Not defined (single class)
GAB,23,23,0,0,23,0,0,1.0,0.0,0.0,0.0,Not defined (single class),Not defined (single class)
GBR,4036,3986,50,364,3622,47,3,0.987611496531219,0.8856447688564477,0.9918256130790191,0.9357326478149101,0.9993405237043853,0.9946005716935234
GEO,92,89,3,1,88,3,0,0.967391304347826,0.25,1.0,0.4,1.0,1.0
GHA,171,171,0,0,171,0,0,1.0,0.0,0.0,0.0,Not defined (single class),Not defined (single class)
GIN,174,174,0,0,174,0,0,1.0,0.0,0.0,0.0,Not defined (single class),Not defined (single class)
GMB,1,1,0,0,1,0,0,1.0,0.0,0.0,0.0,Not defined (single class),Not defined (single class)
GNQ,1,1,0,0,1,0,0,1.0,0.0,0.0,0.0,Not defined (single class),Not defined (single class)
GRC,517,506,11,147,359,11,0,0.9787234042553191,0.930379746835443,1.0,0.9639344262295082,0.9990255561684133,0.9974936847315145
GRD,3,3,0,0,3,0,0,1.0,0.0,0.0,0.0,Not defined (single class),Not defined (single class)
GRL,3,3,0,2,1,0,0,1.0,1.0,1.0,1.0,1.0,1.0
GTM,550,547,3,28,519,3,0,0.9945454545454545,0.9032258064516129,1.0,0.9491525423728814,0.9995894909688013,0.9926049730236922
GUY,22,22,0,0,22,0,0,1.0,0.0,0.0,0.0,Not defined (single class),Not defined (single class)
HND,32,32,0,0,32,0,0,1.0,0.0,0.0,0.0,Not defined (single class),Not defined (single class)
HRV,475,463,12,200,263,11,1,0.9747368421052631,0.9478672985781991,0.9950248756218906,0.970873786407767,0.9982932055053201,0.9977242458081501
HTI,192,190,2,3,187,2,0,0.9895833333333334,0.6,1.0,0.75,1.0,1.0
HUN,561,549,12,69,480,12,0,0.9786096256684492,0.8518518518518519,1.0,0.92,1.0,0.9999999999999997
IDN,8052,8037,15,2779,5258,15,0,0.9981371087928465,0.9946313528990695,1.0,0.997308451462408,0.9999997952730877,0.9999996119608163
IMN,2,2,0,0,2,0,0,1.0,0.0,0.0,0.0,Not defined (single class),Not defined (single class)
IND,2646,2624,22,158,2466,22,0,0.9916855631141346,0.8777777777777778,1.0,0.9349112426035503,0.999824473930563,0.9967965675998204
IRL,517,512,5,43,469,5,0,0.9903288201160542,0.8958333333333334,1.0,0.945054945054945,0.9999018742027279,0.998930625891145
IRN,1844,1838,6,1552,286,6,0,0.9967462039045553,0.9961489088575096,1.0,0.9980707395498393,0.999995586781528,0.9999991699452961
IRQ,1556,1553,3,9,1544,3,0,0.9980719794344473,0.75,1.0,0.8571428571428571,1.0,1.0000000000000002
ISL,38,38,0,0,38,0,0,1.0,0.0,0.0,0.0,Not defined (single class),Not defined (single class)
ISR,357,351,6,28,323,6,0,0.9831932773109243,0.8235294117647058,1.0,0.9032258064516129,0.9999999999999999,0.9999999999999999
ITA,4461,4423,38,1684,2739,37,1,0.9914817305536875,0.9785008715862871,0.9994065281899109,0.9888432178508514,0.9999031546361777,0.9998325036906197
JAM,15,15,0,0,15,0,0,1.0,0.0,0.0,0.0,Not defined (single class),Not defined (single class)
JEY,1,1,0,1,0,0,0,1.0,1.0,1.0,1.0,Not defined (single class),Not defined (single class)
JOR,66,66,0,0,66,0,0,1.0,0.0,0.0,0.0,Not defined (single class),Not defined (single class)
JPN,3560,3546,14,363,3183,14,0,0.9960674157303371,0.9628647214854111,1.0,0.981081081081081,0.9999724259399523,0.9997617350304557
KAZ,606,604,2,105,499,2,0,0.9966996699669967,0.9813084112149533,1.0,0.9905660377358491,0.9999239616006084,0.9996354105307864
KEN,1075,1075,0,3,1072,0,0,1.0,1.0,1.0,1.0,1.0,1.0
KGZ,5,3,2,1,2,2,0,0.6,0.3333333333333333,1.0,0.5,1.0,1.0
KHM,50,50,0,5,45,0,0,1.0,1.0,1.0,1.0,1.0,1.0
KIR,2,2,0,0,2,0,0,1.0,0.0,0.0,0.0,Not defined (single class),Not defined (single class)
KNA,4,0,4,0,0,4,0,0.0,0.0,0.0,0.0,Not defined (single class),Not defined (single class)
KOR,317,305,12,67,238,12,0,0.9621451104100947,0.8481012658227848,1.0,0.9178082191780822,0.9999999999999999,1.0000000000000002
KWT,130,130,0,9,121,0,0,1.0,1.0,1.0,1.0,1.0,1.0
LAO,33,33,0,0,33,0,0,1.0,0.0,0.0,0.0,Not defined (single class),Not defined (single class)
LBN,271,271,0,16,255,0,0,1.0,1.0,1.0,1.0,1.0,1.0
LBR,78,77,1,0,77,1,0,0.9871794871794872,0.0,0.0,0.0,Not defined (single class),Not defined (single class)
LBY,129,129,0,0,129,0,0,1.0,0.0,0.0,0.0,Not defined (single class),Not defined (single class)
LCA,10,10,0,0,10,0,0,1.0,0.0,0.0,0.0,Not defined (single class),Not defined (single class)
LIE,33,33,0,0,33,0,0,1.0,0.0,0.0,0.0,Not defined (single class),Not defined (single class)
LKA,198,197,1,18,179,1,0,0.9949494949494949,0.9473684210526315,1.0,0.972972972972973,1.0,0.9999999999999999
LSO,231,229,2,0,229,2,0,0.9913419913419913,0.0,0.0,0.0,Not defined (single class),Not defined (single class)
LTU,263,263,0,0,263,0,0,1.0,0.0,0.0,0.0,Not defined (single class),Not defined (single class)
LUX,75,75,0,4,71,0,0,1.0,1.0,1.0,1.0,1.0,1.0
LVA,293,283,10,120,163,10,0,0.9658703071672355,0.9230769230769231,1.0,0.96,0.998169556840077,0.9969086520630392
MAR,289,289,0,0,289,0,0,1.0,0.0,0.0,0.0,Not defined (single class),Not defined (single class)
MDA,300,292,8,145,147,7,1,0.9733333333333334,0.9539473684210527,0.9931506849315068,0.9731543624161074,0.9989325742750401,0.999020931577913
MDG,1307,1307,0,0,1307,0,0,1.0,0.0,0.0,0.0,Not defined (single class),Not defined (single class)
MDV,2,2,0,0,2,0,0,1.0,0.0,0.0,0.0,Not defined (single class),Not defined (single class)
MEX,1217,1201,16,451,750,16,0,0.9868529170090387,0.9657387580299786,1.0,0.9825708061002179,0.9999218446967284,0.9998675735546768
MKD,24,24,0,12,12,0,0,1.0,1.0,1.0,1.0,0.9999999999999999,1.0
MLI,489,483,6,52,431,6,0,0.9877300613496932,0.896551724137931,1.0,0.9454545454545454,1.0,1.0
MLT,11,11,0,9,2,0,0,1.0,1.0,1.0,1.0,1.0,1.0
MMR,173,167,6,1,166,6,0,0.9653179190751445,0.14285714285714285,1.0,0.25,1.0,1.0
MNE,20,20,0,5,15,0,0,1.0,1.0,1.0,1.0,1.0,1.0
MNG,32,31,1,0,31,1,0,0.96875,0.0,0.0,0.0,Not defined (single class),Not defined (single class)
MOZ,678,677,1,19,658,0,1,0.9985250737463127,1.0,0.95,0.9743589743589743,1.0,1.0
MRT,200,200,0,16,184,0,0,1.0,1.0,1.0,1.0,0.9999999999999999,1.0
MSR,2,2,0,0,2,0,0,1.0,0.0,0.0,0.0,Not defined (single class),Not defined (single class)
MUS,3,2,1,0,2,1,0,0.6666666666666666,0.0,0.0,0.0,Not defined (single class),Not defined (single class)
MWI,482,479,3,182,297,3,0,0.9937759336099585,0.9837837837837838,1.0,0.9918256130790191,0.9999816849816849,0.9999699753798114
MYS,460,457,3,82,375,3,0,0.9934782608695653,0.9647058823529412,1.0,0.9820359281437125,1.0,0.9999999999999999
NAM,29,29,0,0,29,0,0,1.0,0.0,0.0,0.0,Not defined (single class),Not defined (single class)
NER,111,111,0,0,111,0,0,1.0,0.0,0.0,0.0,Not defined (single class),Not defined (single class)
NGA,1610,1607,3,23,1584,3,0,0.9981366459627329,0.8846153846153846,1.0,0.9387755102040817,1.0,1.0
NIC,41,40,1,3,37,1,0,0.975609756097561,0.75,1.0,0.8571428571428571,1.0,1.0
NLD,4798,4766,32,409,4357,32,0,0.9933305543976657,0.927437641723356,1.0,0.9623529411764706,0.999827307767084,0.9981075221552851
NOR,1460,1459,1,494,965,1,0,0.9993150684931507,0.997979797979798,1.0,0.9989888776541962,1.0,1.0
NPL,1016,1016,0,0,1016,0,0,1.0,0.0,0.0,0.0,Not defined (single class),Not defined (single class)
NZL,1016,1013,3,268,745,3,0,0.9970472440944882,0.988929889298893,1.0,0.9944341372912802,0.9996308564131217,0.9989107901259875
OMN,22,22,0,0,22,0,0,1.0,0.0,0.0,0.0,Not defined (single class),Not defined (single class)
PAK,475,473,2,1,472,2,0,0.9957894736842106,0.3333333333333333,1.0,0.5,1.0,1.0
PAN,25,24,1,4,20,1,0,0.96,0.8,1.0,0.8888888888888888,1.0,1.0
PER,267,263,4,16,247,4,0,0.9850187265917603,0.8,1.0,0.8888888888888888,0.9985059760956175,0.9741137079831933
PHL,940,925,15,282,643,15,0,0.9840425531914894,0.9494949494949495,1.0,0.9740932642487047,0.9996820366897324,0.9992623384389522
PNG,83,83,0,57,26,0,0,1.0,1.0,1.0,1.0,1.0,1.0
POL,3164,3158,6,22,3136,6,0,0.9981036662452591,0.7857142857142857,1.0,0.88,0.9999565997338117,0.9945454545454545
PRK,116,116,0,0,116,0,0,1.0,0.0,0.0,0.0,Not defined (single class),Not defined (single class)
PRT,745,738,7,58,680,7,0,0.9906040268456375,0.8923076923076924,1.0,0.943089430894309,0.9999498067560106,0.999425287356322
PRY,175,167,8,21,146,8,0,0.9542857142857143,0.7241379310344828,1.0,0.84,1.0,1.0
QAT,96,96,0,0,96,0,0,1.0,0.0,0.0,0.0,Not defined (single class),Not defined (single class)
ROU,434,421,13,165,256,13,0,0.9700460829493087,0.9269662921348315,1.0,0.9620991253644315,0.9997521685254027,0.9995981188588361
RUS,6034,6004,30,251,5753,28,2,0.995028173682466,0.899641577060932,0.9920948616600791,0.943609022556391,0.9998728285996173,0.9972552918023863
RWA,112,112,0,0,112,0,0,1.0,0.0,0.0,0.0,Not defined (single class),Not defined (single class)
SAU,184,181,3,6,175,3,0,0.9836956521739131,0.6666666666666666,1.0,0.8,1.0,1.0
SDN,60,58,2,0,58,2,0,0.9666666666666667,0.0,0.0,0.0,Not defined (single class),Not defined (single class)
SEN,3118,3117,1,3084,33,1,0,0.9996792815907634,0.9996758508914101,1.0,0.9998378991732858,1.0,1.0
SGP,72,71,1,28,43,1,0,0.9861111111111112,0.9655172413793104,1.0,0.9824561403508771,1.0,0.9999999999999999
SGS,2,2,0,0,2,0,0,1.0,0.0,0.0,0.0,Not defined (single class),Not defined (single class)
SLB,1,1,0,1,0,0,0,1.0,1.0,1.0,1.0,Not defined (single class),Not defined (single class)
SLE,171,170,1,125,45,1,0,0.9941520467836257,0.9920634920634921,1.0,0.9960159362549801,1.0,1.0000000000000002
SLV,11,11,0,1,10,0,0,1.0,1.0,1.0,1.0,1.0,1.0
SMR,1,1,0,0,1,0,0,1.0,0.0,0.0,0.0,Not defined (single class),Not defined (single class)
SOM,601,601,0,0,601,0,0,1.0,0.0,0.0,0.0,Not defined (single class),Not defined (single class)
SRB,305,297,8,9,288,8,0,0.9737704918032787,0.5294117647058824,1.0,0.6923076923076923,0.9992492492492493,0.9765432098765432
SSD,475,475,0,2,473,0,0,1.0,1.0,1.0,1.0,1.0,1.0
SUR,39,36,3,0,36,3,0,0.9230769230769231,0.0,0.0,0.0,Not defined (single class),Not defined (single class)
SVK,447,447,0,72,375,0,0,1.0,1.0,1.0,1.0,1.0,0.9999999999999999
SVN,163,162,1,38,124,1,0,0.9938650306748467,0.9743589743589743,1.0,0.987012987012987,1.0,0.9999999999999998
SWE,735,727,8,45,682,8,0,0.9891156462585035,0.8490566037735849,1.0,0.9183673469387755,0.9999677938808373,0.9995169082125605
SWZ,58,58,0,14,44,0,0,1.0,1.0,1.0,1.0,1.0,1.0
SYC,22,22,0,19,3,0,0,1.0,1.0,1.0,1.0,1.0,1.0
SYR,7,7,0,0,7,0,0,1.0,0.0,0.0,0.0,Not defined (single class),Not defined (single class)
TCD,277,277,0,0,277,0,0,1.0,0.0,0.0,0.0,Not defined (single class),Not defined (single class)
TGO,118,115,3,0,115,3,0,0.9745762711864406,0.0,0.0,0.0,Not defined (single class),Not defined (single class)
THA,418,410,8,42,368,8,0,0.9808612440191388,0.84,1.0,0.9130434782608695,0.9996833839918946,0.9971748973055593
TKM,55,52,3,1,51,3,0,0.9454545454545454,0.25,1.0,0.4,1.0,1.0
TLS,4,4,0,0,4,0,0,1.0,0.0,0.0,0.0,Not defined (single class),Not defined (single class)
TTO,7,7,0,0,7,0,0,1.0,0.0,0.0,0.0,Not defined (single class),Not defined (single class)
TUN,106,105,1,17,88,1,0,0.9905660377358491,0.9444444444444444,1.0,0.9714285714285714,0.9999999999999999,1.0
TUR,661,653,8,73,580,8,0,0.9878971255673222,0.9012345679012346,1.0,0.948051948051948,0.9999767030099711,0.9998148833765274
TWN,1428,1426,2,7,1419,2,0,0.9985994397759104,0.7777777777777778,1.0,0.875,1.0,1.0
TZA,1248,1244,4,4,1240,4,0,0.9967948717948718,0.5,1.0,0.6666666666666666,1.0,1.0
UGA,772,769,3,1,768,3,0,0.9961139896373057,0.25,1.0,0.4,1.0,1.0
UKR,1376,1357,19,88,1269,19,0,0.9861918604651163,0.822429906542056,1.0,0.9025641025641026,0.9998323687182382,0.9974509560912791
URY,119,118,1,1,117,1,0,0.9915966386554622,0.5,1.0,0.6666666666666666,1.0,1.0
USA,20089,19947,142,3832,16115,142,0,0.9929314550251381,0.9642677403120282,1.0,0.9818088649756598,0.9998550327381056,0.9993131674784517
UZB,527,525,2,5,520,2,0,0.9962049335863378,0.7142857142857143,1.0,0.8333333333333334,1.0,1.0
VAT,2,2,0,0,2,0,0,1.0,0.0,0.0,0.0,Not defined (single class),Not defined (single class)
VCT,12,12,0,0,12,0,0,1.0,0.0,0.0,0.0,Not defined (single class),Not defined (single class)
VEN,106,106,0,15,91,0,0,1.0,1.0,1.0,1.0,1.0,1.0
VNM,624,607,17,244,363,17,0,0.9727564102564102,0.9348659003831418,1.0,0.9663366336633663,0.9999460742018982,0.999915668735063
VUT,2,2,0,0,2,0,0,1.0,0.0,0.0,0.0,Not defined (single class),Not defined (single class)
WSM,1,1,0,0,1,0,0,1.0,0.0,0.0,0.0,Not defined (single class),Not defined (single class)
XKX,50,50,0,10,40,0,0,1.0,1.0,1.0,1.0,1.0,1.0
YEM,241,241,0,0,241,0,0,1.0,0.0,0.0,0.0,Not defined (single class),Not defined (single class)
ZAF,306,306,0,1,305,0,0,1.0,1.0,1.0,1.0,1.0,1.0
ZMB,360,359,1,6,353,1,0,0.9972222222222222,0.8571428571428571,1.0,0.9230769230769231,1.0,1.0
ZWE,444,443,1,180,263,1,0,0.9977477477477478,0.994475138121547,1.0,0.997229916897507,1.0,1.0
